{
  "meta": {
    "name": "Level 2: The Maze",
    "width": 24,
    "height": 24,
    "tileSize": 1.0,
    "spawnPoint": { "x": 2.5, "y": 2.5, "angle": 0.0 },
    "fogDist": 14.0,
    "fogColor": [0.02, 0.05, 0.02]
  },
  "tiles": [
    [1,1,1,1,1,1,1,1,1,1,1,1,1,1,1,1,1,1,1,1,1,1,1,1],
    [1,0,0,0,0,0,0,0,0,0,0,1,0,0,0,0,0,0,0,0,0,0,0,1],
    [1,0,2,2,2,0,0,2,2,2,0,1,0,3,3,3,0,0,3,3,3,0,0,1],
    [1,0,2,0,0,0,0,0,0,2,0,1,0,3,0,0,0,0,0,0,3,0,0,1],
    [1,0,2,0,1,1,1,0,0,2,0,0,0,3,0,1,1,1,0,0,3,0,0,1],
    [1,0,2,0,1,0,0,0,0,2,0,0,0,3,0,1,0,0,0,0,3,0,0,1],
    [1,0,0,0,1,0,0,0,0,0,0,0,0,0,0,1,0,0,0,0,0,0,0,1],
    [1,0,0,0,1,0,0,0,0,0,0,1,0,0,0,1,0,0,0,0,0,0,0,1],
    [1,0,2,0,1,1,0,1,1,1,0,1,0,3,0,1,1,0,1,1,1,0,0,1],
    [1,0,2,0,0,0,0,1,0,0,0,1,0,3,0,0,0,0,1,0,0,0,0,1],
    [1,0,2,2,0,0,0,1,0,0,0,0,0,3,3,0,0,0,1,0,0,0,0,1],
    [1,0,0,0,0,0,0,1,0,0,0,0,0,0,0,0,0,0,1,0,0,0,0,1],
    [1,1,1,1,0,0,0,1,0,0,0,1,1,1,1,0,0,0,1,0,0,0,0,1],
    [1,0,0,0,0,0,0,0,0,0,0,1,0,0,0,0,0,0,0,0,0,0,0,1],
    [1,0,3,0,0,0,0,0,0,0,0,1,0,2,0,0,0,0,0,0,0,0,0,1],
    [1,0,3,3,3,0,0,0,0,3,0,1,0,2,2,2,0,0,0,0,2,0,0,1],
    [1,0,0,0,3,0,1,1,1,3,0,0,0,0,0,2,0,1,1,1,2,0,0,1],
    [1,0,0,0,3,0,1,0,0,0,0,0,0,0,0,2,0,1,0,0,0,0,0,1],
    [1,0,0,0,0,0,1,0,0,0,0,1,0,0,0,0,0,1,0,0,0,0,0,1],
    [1,0,0,0,0,0,1,0,0,0,0,1,0,0,0,0,0,1,0,0,0,0,0,1],
    [1,0,2,0,0,0,1,1,0,1,1,1,0,3,0,0,0,1,1,0,1,1,0,1],
    [1,0,2,2,0,0,0,0,0,0,0,0,0,3,3,0,0,0,0,0,0,0,0,1],
    [1,0,0,0,0,0,0,0,0,0,0,0,0,0,0,0,0,0,0,0,0,0,0,1],
    [1,1,1,1,1,1,1,1,1,1,1,1,1,1,1,1,1,1,1,1,1,1,1,1]
  ],
  "tileTextures": {
    "1": 0,
    "2": 6,
    "3": 12
  },
  "sectors": [
    { "id": 0, "floorTileID": 3, "ceilTileID": 8 }
  ],
  "sprites": [
    { "type": 0, "x": 3.5, "y": 3.5, "fps": 8 },
    { "type": 1, "x": 10.5, "y": 5.5, "fps": 6 },
    { "type": 2, "x": 15.5, "y": 14.5, "fps": 7 },
    { "type": 3, "x": 5.5, "y": 17.5, "fps": 5 },
    { "type": 4, "x": 20.5, "y": 20.5, "fps": 9 }
  ]
}
