{
  "meta": {
    "name": "Level 1: The Entry",
    "width": 16,
    "height": 16,
    "tileSize": 1.0,
    "spawnPoint": { "x": 2.5, "y": 2.5, "angle": 0.0 },
    "fogDist": 12.0,
    "fogColor": [0.05, 0.05, 0.1]
  },
  "tiles": [
    [1,1,1,1,1,1,1,1,1,1,1,1,1,1,1,1],
    [1,0,0,0,0,0,0,0,0,0,0,0,0,0,0,1],
    [1,0,0,0,0,0,0,0,0,0,0,0,0,0,0,1],
    [1,0,0,2,2,2,0,0,0,0,2,2,2,0,0,1],
    [1,0,0,2,0,0,0,0,0,0,0,0,2,0,0,1],
    [1,0,0,2,0,0,0,0,0,0,0,0,2,0,0,1],
    [1,0,0,0,0,0,0,0,0,0,0,0,0,0,0,1],
    [1,0,0,0,0,0,3,3,3,3,0,0,0,0,0,1],
    [1,0,0,0,0,0,3,0,0,3,0,0,0,0,0,1],
    [1,0,0,0,0,0,3,0,0,3,0,0,0,0,0,1],
    [1,0,0,0,0,0,3,3,0,3,0,0,0,0,0,1],
    [1,0,0,2,0,0,0,0,0,0,0,0,2,0,0,1],
    [1,0,0,2,0,0,0,0,0,0,0,0,2,0,0,1],
    [1,0,0,2,2,2,0,0,0,0,2,2,2,0,0,1],
    [1,0,0,0,0,0,0,0,0,0,0,0,0,0,0,1],
    [1,1,1,1,1,1,1,1,1,1,1,1,1,1,1,1]
  ],
  "tileTextures": {
    "1": 0,
    "2": 6,
    "3": 12
  },
  "sectors": [
    { "id": 0, "floorTileID": 5, "ceilTileID": 10 }
  ],
  "sprites": [
    { "type": 0, "x": 4.5, "y": 4.5, "fps": 8 },
    { "type": 1, "x": 9.5, "y": 7.5, "fps": 6 },
    { "type": 0, "x": 12.5, "y": 11.5, "fps": 8 }
  ]
}
